Glasses	Brille
Midi-Pyrénées	Midi-Pyrénées
Turopolje	Turopolje
1418	1418
Limbaži	Limbaži
Sega	Sega
Caserta	Caserta
Praziquantel	Praziquantel
Atrebates	Atrebaten
Ecker	Ecker
Lasithi	Lasithi
Neck	Hals
Cochem	Cochem
Label	Aufkleber
Herbivore	Pflanzenfresser
Brassica	Kohl
Autism	Autismus
Self-service	Selbstbedienung
Rethra	Rethra
Ludwigslust	Ludwigslust
1447	1447
Naarden	Naarden
NP-hardness	NP-Schwere
Salona	Salona
Octahedrite	Oktaedrite
Livestock	Vieh
Mail	Post
Cryovolcano	Kryovulkan
1437	1437
Camouflage	Tarnung
Undead	Untoter
Renkum	Renkum
Amager	Amager
Béjaïa	Bejaia
Nyeri	Nyeri
GameSpy	GameSpy
Varkaus	Varkaus
Compiz	Compiz
Clomifene	Clomifen
Teignmouth	Teignmouth
Mange	Räude
Chimalpopoca	Chimalpopoca
Organogenesis	Organogenese
Doberlug-Kirchhain	Doberlug-Kirchhain
Neuhardenberg	Neuhardenberg
Airbus	Airbus
Circle	Kreis
Magnetism	Magnetismus
Kumasi	Kumasi
Myrmecochory	Myrmekochorie
Bromus	Trespen
Kotka	Kotka
Chape	Ortband
Anabaptism	Täufer
Histone	Histon
Residenz	Residenzstadt
Norwich	Norwich
Renormalization	Renormierung
Alsace	Elsass
Qinghai	Qinghai
Electrophysiology	Elektrophysiologie
Gunship	Gunship
1668	1668
Uznach	Uznach
Cithaeron	Kithairon
Beak	Schnabel
Reichsforschungsrat	Reichsforschungsrat
Hildebrand	Hildebrand
Lance	Lanze
Houseboat	Wohnboot
Nagarjuna	Nagarjuna
Cyclooxygenase	Cyclooxygenasen
Synagogue	Synagoge
Eggplant	Aubergine
Cormega	Cormega
Teleportation	Teleportation
Aesti	Ästier
Tolyatti	Toljatti
Blink-182	Blink-182
Korea	Korea
Rakugo	Rakugo
Diode	Diode
Leominster	Leominster
Maubeuge	Maubeuge
Hydria	Hydria
MIDI keyboard	Masterkeyboard
Fujiwara-kyō	Fujiwara-kyō
Gastronomy	Gastronomie
CD-ROM	CD-ROM
Stoichiometry	Stöchiometrie
Axayacatl	Axayacatl
Grassroots	Graswurzelbewegung
Kalmia	Lorbeerrosen
Geisingen	Geisingen
Haight-Ashbury	Haight-Ashbury
Pangasinan	Pangasinan
Schwa	Schwa
Narashino	Narashino
Knacker	Abdecker
Grevillea	Grevilleen
F-center	Farbzentrum
Neisseria	Neisseria
Wadō-ryū	Wadō-Ryū
Kevelaer	Kevelaer
Flüelen	Flüelen
Tepanec	Tepaneken
Clindamycin	Clindamycin
Interlingua	Interlingua
Escalator	Rolltreppe
1726	1726
Infructescence	Fruchtstand
Speex	Speex
Fălticeni	Fălticeni
Hötorget	Hötorget
HockeyAllsvenskan	HockeyAllsvenskan
Zottegem	Zottegem
Vorticism	Vortizismus
Spintronics	Spintronik
Fabolous	Fabolous
Diameter	Durchmesser
Sensei	Sensei
Foresail	Fockmast
Schwarzburg-Rudolstadt	Schwarzburg-Rudolstadt
Hedonism	Hedonismus
Scintillator	Szintillator
Bracciano	Bracciano
Neuruppin	Neuruppin
Sallum	Sallum
Bray-sur-Somme	Bray-sur-Somme
Hyper-threading	Hyper-Threading
Axim	Axim
Trimurti	Trimurti
Sales	Vertrieb
Selenocysteine	Selenocystein
Reichshoffen	Reichshoffen
Fenestron	Fenestron
Self-control	Selbstkontrolle
Ophthalmology	Augenheilkunde
Nation-building	Nationenbildung
Coevorden	Coevorden
Shuffleboard	Shuffleboard
Uterus	Gebärmutter
Antalyaspor	Antalyaspor
Darwen	Darwen
Quneitra	Quneitra
Milano–Torino	Mailand–Turin
Rearguard	Nachhut
Furcraea	Furcraea
Elephantulus	Elefantenspitzmäuse
Plutino	Plutino
Kanchanaburi	Kanchanaburi
Pacifism	Pazifismus
Ascona	Ascona
Ijtihad	Idschtihād
Hybridity	Hybridität
Taxicab	Taxi
Bivio	Bivio
Cercanías	Cercanías
Planai	Planai
Norðoyar	Nordinseln
Transilien	Transilien
Nominoe	Nominoë
Ibanez	Ibanez
Wülfrath	Wülfrath
Banjarmasin	Banjarmasin
Réveil	Réveil
Demosthenes	Demosthenes
Shareholder	Aktionär
Riez	Riez
Formazza	Formazza
Noisy-le-Grand	Noisy-le-Grand
Holstein	Holstein
Semiramis	Semiramis
Ribnitz-Damgarten	Ribnitz-Damgarten
HyperTransport	HyperTransport
Kirkcaldy	Kirkcaldy
Savenay	Savenay
Whey	Molke
Bathgate	Bathgate
Cadherin	Cadherine
Nose	Nase
Angkor	Angkor
Hörstel	Hörstel
Diffeomorphism	Diffeomorphismus
TomTom	TomTom
Rabbi	Rabbiner
1649	1649
Handball	Handball
Gazebo	Salettl
Underpants	Unterhose
Achondrite	Achondrit
Artaria	Artaria
Geriatrics	Geriatrie
Bushel	Bushel
Levanger	Levanger
Mustelidae	Marder
Wachovia	Wachovia
Creatinine	Kreatinin
Skijoring	Skijöring
Ableism	Ableism
Pierrot	Pierrot
Afterword	Nachwort
Wałbrzych	Wałbrzych
Korfball	Korfball
Mattathias	Mattatias
Vanished	Vanished
TerraSAR-X	TerraSAR-X
Luino	Luino
Arionidae	Wegschnecken
Oolite	Oolith
Pan-Africanism	Panafrikanismus
Ovamboland	Ovamboland
Mombach	Mainz-Mombach
Galilee	Galiläa
Lysychansk	Lyssytschansk
Kiruna	Kiruna
Sapper	Sappeur
Paros	Paros
Neoptera	Neuflügler
Lanciano	Lanciano
Samogitia	Samogitien
Nekhbet	Nechbet
Bunte	Bunte
Dermatophyte	Dermatophyt
Szentendre	Szentendre
Dolman	Dolman
Ichthyosis	Ichthyose
Klina	Klina
Weißenthurm	Weißenthurm
Champigny-sur-Marne	Champigny-sur-Marne
Geochemistry	Geochemie
Vernonia	Scheinastern
Kavala	Kavala
Trier	Trier
Kehdingen	Kehdingen
Satelight	Satelight
PMR446	PMR-Funk
Schleswig-Holstein-Sonderburg	Schleswig-Holstein-Sonderburg
Puppetry	Puppentheater
Mufulira	Mufulira
1757	1757
Bellinzona	Bellinzona
Hefei	Hefei
1516	1516
Shirkuh	Schirkuh
Hypothermia	Hypothermie
Bavaria-Landshut	Bayern-Landshut
Haplogroup	Haplogruppe
Limburger	Limburger
Cuauhtémoc	Cuauhtémoc
Kimchi	Kimchi
Aponeurosis	Aponeurose
Tokmok	Tokmok
Aeëtes	Aietes
Flagship	Flaggschiff
Myofibril	Muskelfibrille
Kousséri	Kousséri
Södermalm	Södermalm
Lamassu	Lamassu
Bruyères	Bruyères
Roderic	Roderich
Vehicle	Fahrzeug
Pneumothorax	Pneumothorax
Gratian	Gratian
Ashina	Aschina
Luzula	Hainsimsen
Brake	Bremse
Shōgun	Shōgun
Throughput	Durchsatz
Strawberry	Gartenerdbeere
MPEG-4	MPEG-4
Metic	Metöke
Krummhörn	Krummhörn
Komotini	Komotini
Muzzleloader	Vorderlader
Quinine	Chinin
Skuodas	Skuodas
PlanetMath	PlanetMath
Suffolk	Suffolk
Folliculitis	Follikulitis
Argania	Arganbaum
Hypogeum	Hypogäum
Zhuzhou	Zhuzhou
Cake	Kuchen
Chautauqua	Chautauqua
Lamprey	Neunaugen
Kōriyama	Kōriyama
Płoty	Płoty
Gamete	Gamet
Obersalzberg	Obersalzberg
Licinius	Licinius
Snizhne	Snischne
Thonon-les-Bains	Thonon-les-Bains
Sanary-sur-Mer	Sanary-sur-Mer
Enduro	Endurosport
Bikini	Bikini
Illnau-Effretikon	Illnau-Effretikon
Saxe-Eisenach	Sachsen-Eisenach
Odeonsplatz	Odeonsplatz
Ngāpuhi	Ngāpuhi
Competition	Wettkampf
Stegosaurus	Stegosaurus
Khazars	Chasaren
Apocalypto	Apocalypto
Melanthiaceae	Germergewächse
Leleges	Leleger
Arianespace	Arianespace
Folkestone	Folkestone
Tredegar	Tredegar
Thermite	Thermit
Silingi	Silingen
Mondovì	Mondovì
Alibi	Alibi
Chalonnes-sur-Loire	Chalonnes-sur-Loire
Hentai	Hentai
Reuters	Reuters
Silanes	Silane
Laminaria	Laminaria
Wisłoka	Wisłoka
Silphidae	Aaskäfer
Byblos	Byblos
Sarnath	Sarnath
Isostasy	Isostasie
Ankylosauria	Ankylosauria
Deggendorf	Deggendorf
Yōkai	Yōkai
Tenby	Tenby
Canberra	Canberra
Nisko	Nisko
Chad	Tschad
Ixelles	Ixelles/Elsene
Wattwil	Wattwil
Scafati	Scafati
DW-TV	DW-TV
Cordia	Kordien
Posidonius	Poseidonios
Tabora	Tabora
Poxviridae	Poxviridae
Obervellach	Obervellach
Krypteria	Krypteria
Actinolite	Aktinolith
Peripeteia	Peripetie
Skye	Skye
Sousse	Sousse
Shack	Baracke
Landivisiau	Landivisiau
Bordeaux–Paris	Bordeaux–Paris
Infinitive	Infinitiv
ThyssenKrupp	ThyssenKrupp
Blois	Blois
QuickTime	QuickTime
Zeulenroda-Triebes	Zeulenroda-Triebes
Acanthuridae	Doktorfische
Lophotrochozoa	Lophotrochozoen
Sylhet	Sylhet
Nucleophile	Nukleophilie
Bleiburg	Bleiburg
Downburst	Downburst
Ebionites	Ebioniten
Chancellor	Kanzler
Écu	Écu
OpenBSD	OpenBSD
Erythropoietin	Erythropoetin
Endianness	Byte-Reihenfolge
Novatian	Novatian
Ebermannstadt	Ebermannstadt
Calamites	Kalamiten
Thumbelina	Däumelinchen
Anouvong	Anuvong
1918	1918
Battle	Schlacht
Hypnos	Hypnos
Paideia	Paideia
Teano	Teano
Photomontage	Fotomontage
Spermophilus	Ziesel
A-League	A-League
Oulipo	Oulipo
Ziggurat	Zikkurat
Gzhelian	Gzhelium
Västervik	Västervik
Potash	Kalisalz
Agroforestry	Agroforstwirtschaft
Medina	Medina
Ampersand	Et-Zeichen
Knee	Kniegelenk
Cniva	Kniva
Aulopiformes	Eidechsenfischverwandte
Gyaros	Gyaros
Monarchianism	Monarchianismus
Pericardium	Herzbeutel
Łobżenica	Łobżenica
Eppstein	Eppstein
Repeater	Repeater
A7V	A7V
Meghalaya	Meghalaya
Heimatvertriebene	Heimatvertriebene
Schmölln	Schmölln
Keytar	Umhängekeyboard
Bacteroides	Bacteroides
Kodaline	Kodaline
Decapoda	Zehnfußkrebse
Ingredient	Zutatenliste
Lodève	Lodève
Agrinio	Agrinio
Netphen	Netphen
Molokai	Molokaʻi
Muscari	Traubenhyazinthen
Quiksilver	Quiksilver
Saxifragales	Steinbrechartige
Zahlé	Zahlé
Värnamo	Värnamo
Thatcherism	Thatcherismus
Woleai	Woleai
Patrimonialism	Patrimonialismus
Doxorubicin	Doxorubicin
Aletschhorn	Aletschhorn
Orpheus	Orpheus
Fianarantsoa	Fianarantsoa
Heckelphone	Heckelphon
Legcuffs	Fußschellen
Parakou	Parakou
Swissair	Swissair
Thermoforming	Thermoformen
Velia	Elea
Dermatophytosis	Dermatophytose
Minusinsk	Minussinsk
Drenica	Drenica
Ethylbenzene	Ethylbenzol
Hemotoxin	Blutgift
Brinje	Brinje
Aizpute	Aizpute
Habilitation	Habilitation
Mononitrotoluene	Nitrotoluole
Thermokarst	Thermokarst
Latsch	Latsch
Lisburn	Lisburn
Sopot	Sopot
Gnosticism	Gnosis
1755	1755
Deinonychus	Deinonychus
Constitutionality	Verfassungswidrigkeit
Ostashkov	Ostaschkow
Dena'ina	Dena'ina
Boustrophedon	Bustrophedon
Nossen	Nossen
Impresario	Impresario
Ceratopsidae	Ceratopsidae
Biofilm	Biofilm
Šid	Šid
Mikkeli	Mikkeli
Krewella	Krewella
Radio	Funkverkehr
Polyimide	Polyimide
Hermit	Eremit
Villeneuve-lès-Avignon	Villeneuve-lès-Avignon
Volvulus	Volvulus
Kaká	Kaká
Sharif	Scherif
Bundaberg	Bundaberg
Raiffeisenbank	Raiffeisen
Tienen	Tienen
Azerbaijanis	Aserbaidschaner
Quackery	Quacksalber
Kmart	Kmart
Zinfandel	Primitivo
Kauhajoki	Kauhajoki
Neotantra	Neotantra
Vexillology	Vexillologie
Tauragė	Tauragė
Sylvite	Sylvin
LINPACK	LINPACK
Hogshead	Oxhoft
Galashiels	Galashiels
Hemiptera	Schnabelkerfe
Horseshoe	Hufeisen
Commodus	Commodus
Liberty	Freiheit
Hellerup	Hellerup
Puffinus	Sturmtaucher
Slutsk	Sluzk
Jargon	Jargon
Visegrád	Visegrád
Neoplan	Neoplan
Franeker	Franeker
Kannada	Kannada
Culvert	Durchlass
Pronunciamiento	Pronunciamiento
Brazil	Brasilien
Anacapri	Anacapri
PAYGO	Umlageverfahren
Coppersmith	Kupferschmied
Solferino	Solferino
Rhinophore	Rhinophore
Sleipnir	Sleipnir
Ancestor	Vorfahr
Lorde	Lorde
Melhus	Melhus
Kyffhäuserkreis	Kyffhäuserkreis
Wuchiapingian	Wuchiapingium
Mahallah	Machalla
Ogive	Ogive
Arcosolium	Arkosolium
Panagia	Panagia
Hesse	Hessen
Kourion	Kourion
Cyanide	Cyanide
Aquaporin	Aquaporine
Rhondda	Rhondda
Eurobarometer	Eurobarometer
Rail (bird)	Rallenvögel
Tachisme	Tachismus
Mucin	Mucine
Querqueville	Querqueville
Frigidarium	Frigidarium
Adduct	Addukt
Rajka	Rajka
Riom	Riom
Rutile	Rutil
Triclosan	Triclosan
Cres	Cres
Eskom	Eskom
War	Krieg
1645	1645
Lauchhammer	Lauchhammer
Baunatal	Baunatal
Pointe-à-Pitre	Pointe-à-Pitre
Berkel	Berkel
Tribology	Tribologie
Konitsa	Konitsa
Duden	Duden
Tide	Gezeiten
1583	1583
Barn-owl	Schleiereulen
Decoction	Dekokt
Ladytron	Ladytron
Domont	Domont
Morrissey	Morrissey
Bowline	Palstek
Authari	Authari
Alligatoridae	Alligatoren
Donauinsel	Donauinsel
Sedation	Sedierung
Glassjaw	Glassjaw
Regent	Reichsverweser
Preschool	Vorschule
Psaltery	Psalterium
Sovkhoz	Sowchos
Zalando	Zalando
Leidang	Leidang
Tungstate	Wolframate
Müller-Thurgau	Müller-Thurgau
Zboriv	Sboriw
Dodecagon	Zwölfeck
1927	1927
Kiowa	Kiowa
Johanngeorgenstadt	Johanngeorgenstadt
Tonsil	Tonsille
Cedilla	Cedille
Madball	Madball
Nationalization	Verstaatlichung
Platanthera	Waldhyazinthen
Kenpeitai	Kempeitai
Pantry	Speisekammer
Laktaši	Laktaši
Salon-de-Provence	Salon-de-Provence
1898	1898
Chernogolovka	Tschernogolowka
Plush	Plüsch
Pericles	Perikles
Hollywood	Hollywood
Calla	Drachenwurz
Imam	Imam
Spectrometer	Spektrometer
Caracal	Karakal
Siegerland	Siegerland
Baud	Baud
Requiem	Requiem
Bridgetown	Bridgetown
Ravioli	Ravioli
Awasa	Awassa
Heteronormativity	Heteronormativität
Westfalenhallen	Westfalenhallen
Dodge	Dodge
Phonograph	Phonograph
Weldability	Schweißeignung
Lommel	Lommel
Sympatry	Sympatrie
Kaluga	Kaluga
Petroșani	Petroșani
Lecturer	Lecturer
Echinococcus	Echinococcus
Trochoid	Zykloide
1,2-Dichloroethane	1,2-Dichlorethan
1297	1297
Picometre	Pikometer
Eidsberg	Eidsberg
Lugworm	Wattwurm
Lindos	Lindos
Weakness	Asthenie
Tlatoani	Tlatoani
Gratitude	Dankbarkeit
Pokhara	Pokhara
Senescence	Biogerontologie
Churubusco	Churubusco
Prediction	Prognose
Eugenius	Eugenius
L'Express	L’Express
Buttermilk	Buttermilch
Montemor-o-Novo	Montemor-o-Novo
Kampfgruppe	Kampfgruppe
Antiandrogen	Antiandrogene
Myspace	Myspace
Cryptography	Kryptographie
Aphrodisias	Aphrodisias
Wikipedia:Categorization	Wikipedia:Kategorien
Lycaenidae	Bläulinge
Glomma	Glomma
Zelenogradsk	Selenogradsk
LIGO	LIGO
Euarchontoglires	Euarchontoglires
Sphagnum	Torfmoose
Eggenstein-Leopoldshafen	Eggenstein-Leopoldshafen
Cercus	Cercus
Łowicz	Łowicz
Vial	Phiole
Poaceae	Süßgräser
Kerala	Kerala
THX	THX
Cuboctahedron	Kuboktaeder
Schibsted	Schibsted
Ariccia	Ariccia
Elne	Elne
Stabiae	Stabiae
Lied	Kunstlied
Rasp	Raspel
Ode	Ode
Yoshiwara	Yoshiwara
Bituriges	Biturigen
1315	1315
Amtsgericht	Amtsgericht
1340	1340
Škofljica	Škofljica
Handball-Bundesliga	Handball-Bundesliga
Maryknoll	Maryknoll-Missionsorden
Flavonoid	Flavonoide
Opportunism	Opportunismus
Astrophotography	Astrofotografie
Charango	Charango
Nekton	Nekton
Tczew	Tczew
946	946
Intentionality	Intentionalität
Menes	Menes
Fissure	Fissur
Simtek	Simtek
Prostate	Prostata
Copperbelt	Copperbelt
Sexism	Sexismus
Ankylosaurus	Ankylosaurus
Felling	Fälltechnik
Arrecife	Arrecife
Vulcanization	Vulkanisation
Vexillum	Vexillum
Dinoflagellate	Dinoflagellaten
Telemedicine	Telemedizin
Ston	Ston
Sarnia	Sarnia
December	Dezember
Strychnine	Strychnin
Accordion	Akkordeon
Osdorp	Osdorp
Retinal	Retinal
Medulloblastoma	Medulloblastom
Agribusiness	Lebensmittelwirtschaft
Geseke	Geseke
Ruppia	Salden
Almond	Mandelbaum
Keolis	Keolis
Initiation	Initiation
Koelnmesse	Koelnmesse
Sunscreen	Sonnencreme
Bendir	Bendir
Gallarate	Gallarate
Szczekociny	Szczekociny
Khorramshahr	Chorramschahr
Fürst	Fürst
Archanes	Archanes
Orahovac	Rahovec
Dionysia	Dionysien
Joigny	Joigny
Tegucigalpa	Tegucigalpa
Kazakhstan	Kasachstan
Speedometer	Tachometer
Chaulnes	Chaulnes
Paca	Pakas
Peucetians	Peuketien
Anolis	Anolis
Dalmatia	Dalmatien
Barbastelle	Mopsfledermaus
Romorantin-Lanthenay	Romorantin-Lanthenay
Karonga	Karonga
Sacile	Sacile
Alphas	Alphas
Pentane	N-Pentan
Escada	Escada
Causses	Causse
Wächtersbach	Wächtersbach
Astypalaia	Astypalea
Troubadour	Trobador
1522	1522
Pontebba	Pontebba
Tysmenytsia	Tysmenyzja
Oderzo	Oderzo
Jihad	Dschihad
1503	1503
Instanton	Instanton
Welkom	Welkom
Drawbridge	Zugbrücke
Nekhen	Hierakonpolis
Monoicous	Monözie
Snowmelt	Schneeschmelze
Glauchau	Glauchau
Bardejov	Bardejov
Cerruti	Cerruti
Gel	Gel
Sikhism	Sikhismus
Dominica	Dominica
Moringen	Moringen
Meister	Meister
Nero	Nero
Rheinwiesenlager	Rheinwiesenlager
Trunnion	Schildzapfen
Prothorax	Prothorax
Collocation	Kollokation
Chromaticity	Farbart
Tri-Rail	Tri-Rail
Municipality	Gemeinde
Ẓāhirī	Zahiriten
Hässleholm	Hässleholm
Hukbalahap	Hukbalahap
Saint-Avold	Saint-Avold
Speleology	Speläologie
Pleonasm	Pleonasmus
Macumba	Macumba
Anchor	Anker
Torsby	Torsby
Z-drive	Schottel-Ruderpropeller
Tow	Werg
Vase	Vase
Mainz	Mainz
Dormer	Dachgaube
Pedant	Pedant
Anchovy	Sardellen
Kalavryta	Kalavryta
Gym	Turnhalle
Wagria	Wagrien
Gwar	Gwar
Penicillin	Penicilline
Exhibition	Ausstellung
Blancanieves	Blancanieves
Langhe	Langhe
Hydropower	Wasserkraft
Czorsztyn	Czorsztyn
Gdov	Gdow
Ethereum	Ethereum
Lomé	Lomé
Brucknerhaus	Brucknerhaus
Loimaa	Loimaa
Stiction	Haftreibung
Quran	Koran
Konditorei	Konditorei
Flavones	Flavone
Veteran	Veteran
Cuarteto	Cuarteto
Saronno	Saronno
Reappropriation	Geusenwort
Shoal	Sandbank
Capo	Kapodaster
Honningsvåg	Honningsvåg
Pirkanmaa	Pirkanmaa
Yttrium	Yttrium
Abenaki	Abenaki
Raisio	Raisio
Vahana	Vahana
Precocial	Nestflüchter
Thiourea	Thioharnstoff
Album	Musikalbum
Saint-Étienne-du-Mont	St-Étienne-du-Mont
Lika	Lika
Monschau	Monschau
Udon	Udon
Benefice	Vikarie
1383	1383
Algeciras	Algeciras
Ambala	Ambala
Sestos	Sestos
Perfusion	Durchblutung
Sucy-en-Brie	Sucy-en-Brie
Kalmar	Kalmar
T-shirt	T-Shirt
Decapitation	Enthauptung
Marcq-en-Barœul	Marcq-en-Barœul
Ceratosaurus	Ceratosaurus
Terpenoid	Terpenoide
Audiology	Audiologie
Bihać	Bihać
Macrocephaly	Makrozephalie
Mural	Wandmalerei
Halteres	Haltere
Gmunden	Gmunden
Tempelhof	Berlin-Tempelhof
Chorizo	Chorizo
Chittorgarh	Chittorgarh
Blaubeuren	Blaubeuren
Mecachrome	Mecachrome
Proto-language	Ursprache
Indumentum	Indument
Baryon	Baryon
Parsnip	Pastinak
Gong	Gong
Sárospatak	Sárospatak
Novalis	Novalis
Naiskos	Naïskos
Tharangambadi	Tharangambadi
Pessinus	Pessinus
Herculis	Herculis
Hemipenis	Hemipenis
Scheveningen	Scheveningen
Eleusis	Eleusis
Kremmen	Kremmen
Ismailia	Ismailia
Drawno	Drawno
Orthodontics	Kieferorthopädie
Barbiturate	Barbiturate
Beta-galactosidase	Β-Galactosidase
Zipaquirá	Zipaquirá
Gyöngyös	Gyöngyös
Mechanic	Mechaniker
Djoser	Djoser
Enz	Enz
Ninox	Buschkäuze
Overdoor	Supraporte
Kamen	Kamen
Peninsula	Halbinsel
Samnium	Samnium
Magirus	Magirus
Celebrity	Prominenz
1944	1944
Philebus	Philebos
Bifidobacterium	Bifidobacterium
Ciney	Ciney
Olybrius	Olybrius
Haiku	Haiku
Alphavirus	Alphavirus
Tench	Schleie
Foraminifera	Foraminiferen
Olot	Olot
Size	Abmessungen
Fólkvangr	Folkwang
Dryopithecus	Dryopithecus
Landgrave	Landgraf
Epididymitis	Epididymitis
RedOne	RedOne
Quenya	Quenya
Hatebreed	Hatebreed
1291	1291
Heusden-Zolder	Heusden-Zolder
Faras	Faras
Varicocele	Varikozele
Hadad	Adad
Phenylpropanoid	Phenylpropanoide
Lyrebird	Leierschwänze
Acerra	Acerra
Cultivator	Grubber
Staccato	Staccato
Karviná	Karviná
Turboprop	Turboprop
Finca	Finca
Ruff	Kampfläufer
Jocasta	Iokaste
Tooltip	Tooltip
Day	Tag
Cyanidin	Cyanidin
Prairial	Prairial
Chromophore	Chromophor
Bletchley	Bletchley
Raalte	Raalte
Riedstadt	Riedstadt
Beer	Bier
Fustat	Fustāt
KazMunayGas	KazMunayGas
Phytolaccaceae	Kermesbeerengewächse
Commer	Commer
Stolperstein	Stolpersteine
Portbou	Portbou
Sonata	Sonate
Octahedron	Oktaeder
Rifampicin	Rifampicin
Idyll	Idyll
METAR	METAR
Albstadt	Albstadt
Nabonidus	Nabonid
Pinniped	Robben
1828	1828
Crunk	Crunk
Superstructure	Decksaufbau
Glioma	Gliom
1626	1626
Kharosthi	Kharoshthi-Schrift
Riberalta	Riberalta
Arikara	Arikaree
Methyltransferase	Methyltransferase
Monolayer	Monolage
Sydney	Sydney
Watermael-Boitsfort	Watermael-Boitsfort/Watermaal-Bosvoorde
Neuraminidase	Neuraminidase
Juvisy-sur-Orge	Juvisy-sur-Orge
Bárðarbunga	Bárðarbunga
Afsluitdijk	Abschlussdeich
Kvinnherad	Kvinnherad
Humanoid	Humanoid
Chieti	Chieti
Polarizability	Polarisierbarkeit
Itelmens	Itelmenen
Supercruise	Supercruise
Vereinsthaler	Vereinstaler
Sholay	Sholay
Sulzbach-Rosenberg	Sulzbach-Rosenberg
Aerobatics	Kunstflug
Priam	Priamos
Confectionery	Konfekt
Montivilliers	Montivilliers
Vestvågøy	Vestvågøy
Farsala	Farsala
Polyphenol	Polyphenole
Fezzan	Fessan
Urk	Urk
Optometry	Optometrie
Efringen-Kirchen	Efringen-Kirchen
Carmignano	Carmignano
Würzburg	Würzburg
Aquaman	Aquaman
Elis	Elis
Mopti	Mopti
Notodden	Notodden
Georgsmarienhütte	Georgsmarienhütte
Faaborg	Faaborg
Michelin	Michelin
Edelény	Edelény
Geheimrat	Geheimrat
Monfalcone	Monfalcone
Piaseczno	Piaseczno
W.I.T.C.H.	W.i.t.c.h.
Deira	Deira
Lempel–Ziv–Welch	Lempel-Ziv-Welch-Algorithmus
Hexose	Hexosen
Insecticide	Insektizid
Cergy	Cergy
Comacchio	Comacchio
Otterndorf	Otterndorf
Edema	Ödem
Phalsbourg	Phalsbourg
Moncton	Moncton
1554	1554
Pan-Slavism	Panslawismus
Epoxide	Epoxide
Oodnadatta	Oodnadatta
Scholae	Choralschola
Gigantism	Riesenwuchs
Windermere	Windermere
Litter	Vermüllung
Tenoch	Ténoch
Chlorate	Chlorate
Ukmergė	Ukmergė
Steamboat	Dampfschiff
Scania	Schonen
Pharynx	Rachen
Sliema	Sliema
Feather	Feder
Olhão	Olhão
Geomatics	Geomatik
Bamboo	Bambus
Webcast	Webcast
Cretinism	Kretinismus
Phoroneus	Phoroneus
Ludovingians	Ludowinger
Stoning	Steinigung
Wolmirstedt	Wolmirstedt
Erasmusbrug	Erasmusbrücke
Praxiteles	Praxiteles
Landscape	Landschaft
Lausanne	Lausanne
Aussersihl	Aussersihl
Veneridae	Venusmuscheln
Bagan	Bagan
Danzón	Danzón
Traunviertel	Traunviertel
Chinoiserie	Chinoiserie
Gorgon	Gorgonen
